20,15
wwwwwwwwwwwwwwwwwwww
w------------------w
w------------------w
w------------------w
w------------------w
w----------g-------w
w------------------w
w------------------w
w------------------w
w-----------g------w
w-------wwwwww-----w
w------------------w
w------------------w
w------------------w
wwwwwwwwwwwwwwwwwwww